["****************************************",
"O                              *********",
"****** *********************** *********",
"****** *********************** *********",
"****** *********************** *********",
"****** *********************************",
"****** *********************************",
"****** *********************************",
"****** *********************************",
"******                   ***************",
"************* **************************",
"************* **************************",
"************* **************************",
"************* **************************",
"************* **************************",
"*************                ***********",
"**************************** ***********",
"**************************** ***********",
"**************************** ***********",
"**************************** ***********",
"*********                              X",
"********* ******************************",
"********* ******************************",
"********* ******************************",
"********* ******************************",
"********* ******************************",
"********* ******************************",
"********* ******************************",
"****************************************"]
