"****************************************"
"O                              *********"
"****** *********************** *********"
"****** *********************** *********"
"****** *********************** *********"
"****** *********************************"
"****** *********************************"
"****** *********************************"
"****** *********************************"
"******                   ***************"
"************* **************************"
"************* **************************"
"************* **************************"
"************* **************************"
"************* **************************"
"*************                ***********"
"**************************** ***********"
"**************************** ***********"
"**************************** ***********"
"**************************** ***********"
"*********                              X"
"********* ******************************"
"********* ******************************"
"********* ******************************"
"********* ******************************"
"********* ******************************"
"********* ******************************"
"********* ******************************"
"****************************************"
