["****************************************",
"*O                                     *",
"* * * **************** *************** *",
"* * *               ** *               *",
"* * ********* ******** * * *********** *",
"* * ****************** * * *********** *",
"* * **                 * *        **** *",
"* * ** * ********************* ** **** *",
"* * ** *     ***************** **   ** *",
"* * ** ***** **              * **** ** *",
"* * ** ***** ** ** ********* * **** ** *",
"* * ** **    ** **        ** * **   ** *",
"* * ** ** ** ** ** ****** ** * ** * ** *",
"* * ** ******** ** ****   ** * ** **** *",
"* * **          ** **** **** * ** **** *",
"**************************** * ** **** *",
"*                            * **    * *",
"* ****** *************************** * *",
"* *** ** ********               **** * *",
"*     ** ******** ************* **** * *",
"* ** * *                   **** **** * *",
"* ** * * ******* ************** ****** *",
"* **   * *** *** ***********************",
"* ********** ************              *",
"*                      ** * * ****** * *",
"* **** ***** ************ * *    * * * *",
"* ********** ************ * ****** * * *",
"*                         *        * *X*",
"****************************************"]