["****************************************",
"O                                      *",
"******** ******** ******** *********** *",
"* ****** ******** ******** *********** *",
"* ****** ******** ******** *********** *",
"* ****** ********      *** *********** *",
"*        ******** ******** *********** *",
"* ****** ******** ******** *********** *",
"* ****** ******** ********           * *",
"* ****** *************************** * *",
"* **     *********                   * *",
"**** ************* ******************* *",
"**** **                     ******* ** *",
"**** ** *** ****** **************** ** *",
"* ** ** *** ****** **************** ** *",
"* ** ** *** ******             **** ** *",
"* ** ** *** ****** *********** **** ** *",
"* ** ** *** ****** ***********      ** *",
"*    ** *** ************************** *",
"**** ** *** ***                     ****",
"**** ** *** *** ******************* ****",
"**** ** *** *** ******************* ****",
"**** ** *** *** ***          ****** ****",
"**** ** *** *** *** ******** ****** ****",
"**** ** *** *** *** ******** ****** ****",
"**** ** *** *** *** ********        ****",
"**** ** ******* *** ********************",
"**** **         ***                    X",
"****************************************"]
