["****************************************",
"*O              ******     *************",
"***** ********* ****** *** *************",
"***** ********* ****** *** *************",
"***** ********* ****** *** *************",
"***** ********* ****** ***         *****",
"***** ********* ****** *********** *****",
"***** ********* ****** *********** *****",
"***** ********* ****** *********** *****",
"***** ********* ****** *********** *****",
"***** ********* ****** *********** *****",
"***** ********* ****** *********** *****",
"***** ********* ****** *********** *****",
"***** ********* ****** *********** *****",
"***** ********* ****** ****        *****",
"***** ********* ****** *********** *****",
"***** ********* ****** *********** *****",
"***** ********* ****** ***********  *****",
"***** ********* ****** ************ ****",
"***** ********* ****** ************ ****",
"***** ********* ****** ************ ****",
"***** ********* ****** *****************",
"***** *********                        *",
"***** ******************************** *",
"***** *****        ***      ******* ** *",
"***** ***** ****** *** **** ******* ** *",
"***** ***** ********** ****         ** *",
"*****                  ***************X*",
"****************************************",]