["****************************************",
"*O                                     *",
"* ************************************ *",
"* ***                                  *",
"* *** **********************************",
"* ***                                  *",
"* ************************************ *",
"* ***                                  *",
"* *** **********************************",
"* ***                                  *",
"* ************************************ *",
"* ***                                  *",
"* *** **********************************",
"* ***                                  *",
"* ************************************ *",
"* ***                                  *",
"* *** **********************************",
"* ***                                  *",
"* ************************************ *",
"* ************************************ *",
"*                                  *** *",
"********************************** *** *",
"********************************** *** *",
"***                                *** *",
"** *********************************** *",
"** *****                          **** *",
"** ***** ************************ **** *",
"**       *******                  ****X*",
"****************************************",]